                    
   #################
   #                
   #    #########   
   #            #   
   #            #   
   #            #   
   ##############   
            #####   
            #####   
########    #####   
########    #####   
########    #####   
            #####   
            #####   
            #####   
    #############   
    #############   
                    
                    
